***************************
*.........................*
*.*******************.*****
*.*****.***G..........**.**
*.*****.****************.**
*.*****.....*.**********.**
*.*********.*............**
*.*********.******.********
*.....S............********
***************************
