*************
*...........*
*.*********G*
*.***********
*.*********.*
*.*********.*
*.*********.*
*.*********.*
*.....S.....*
*************
