***************
***************
*.****........*
*.****.******.*
*.****.******.*
*.****.******.*
*.****.******.*
*.****.********
*.....S.....*G*
*.****.********
*.****.******.*
*.****.******.*
*.****.******.*
*.****.******.*
*.****........*
***************
***************
