***************************
*.........................*
*.*******************.*****
*.**..*.***G..........**.**
*.**.**.****************.**
*.**.**.....*.**********.**
*.**.******.*............**
*.**.******.******.********
*.....S............********
***************************
