**********************
*S..........********G*
*.*********.********.*
*.*********.********.*
*........**.********.*
*.*********.********.*
*.*********.********.*
*.*********.********.*
*.*********.********.*
*.*********.********.*
*.*********.********.*
*.*********.********.*
*.*********.********.*
*.*********.********.*
*.*********.********.*
*.*********.********.*
*.*********.********.*
*.*********.********.*
*.*********.********.*
*.******************.*
*....................*
**********************